11111111111111111111
1P00000001000000C001
10001110001111000001
100X0010000000100001
1000C01000000C10X001
10111001111100010101
1000C0000C0000010001
10000X0000000000E001
1C0000111000X0000C01
11111111111111111111
