111111111111111111111111111111
1P00000000100000000000000000E1
101111011101111111110111101101
1C0000000010000X00000000000001
101011111101111011111011101101
1X000000C0000000000010000000X1
101111111111101111111011101101
100000000010000000001000000001
101011111111111101111011111101
1C0000000X0000000C0000100000C1
101111111101111111111111101101
100000000001000000001000000001
101011111111111011111111101101
1X000000000000X00000000C0000X1
111111111111111111111111111111
