111111111111111111111111111111111111111
1P00000000000100000000000000X00000000C1
100011110000011100011110000000001000001
100000000C00000000000001000000000110001
10000111111100011110X010001110000000001
1000C000000010000000000C0010000000C0001
101111000011100011111000001011111100001
10000X000000000C00000100000000000100001
10000001110000111000000110000X001000001
100000000000000000000000000000000000001
100011111111000111111000111111100001001
1000C0000000100000000000000000000000001
101111000011100011111111101111111000001
1000000000000000000000000000C0000000001
100X00001110000111000111000111000011001
10000000000000000000X000000000000000E01
100011111111000111111000111111100001001
1C0000000000C0000000000000C0000000000C1
100000000011100011110000000001000000001
111111111111111111111111111111111111111
