111111111111111111111
1P00000000000100000E1
101011101110101110101
1C0000X00000100000001
101110111011101110101
1X000000C0000000000X1
101011101110111011101
1C00001000001000000C1
101110101110101110101
111111111111111111111
