1111111111
1P0E0000C1
1111111111
