1111111
1P000P1
1000C01
1E00001
1111111
