1111111
1P000E1
1000101
1E00001
1111111
