1111111
1P010C1
10#0101
1E00031
1111111
