1111111
1P00001
1000101
1E00001
1111111
