1111111
10000C1
1000101
1E00001
1111111
