1111111
1P11111
1111111
1E000C1
1111111
