1111111
1P000C1
1000101
1E00001
1111101
