11111111111111111111
1P00000000100000C001
10001110000111100001
10000010000000100001
1000C01000000C100001
10111001111100010001
1000C0000C0000010001
1000000000000000E001
1C000011100000000C01
11111111111111111111
