1111111111111
1001C100000C1
1001000110001
101000011C001
1000C11111001
1P0011E000C01
1111111111111
